level1.txt

##########
#        #
#  P     #
#        #
#        #
#   G    #
#        #
##########